20:23:00:00:00:01
20:23:00:00:00:02
20:23:00:00:00:03
20:23:00:00:00:04
20:23:00:00:00:05
20:23:00:00:00:06
20:23:00:00:00:07
20:23:00:00:00:08
20:23:00:00:00:09
20:23:00:00:00:10
20:23:00:00:00:11
20:23:00:00:00:12
20:23:00:00:00:13
20:23:00:00:00:14
20:23:00:00:00:15
20:23:00:00:00:16
20:23:00:00:00:17
20:23:00:00:00:18
20:23:00:00:00:19
20:23:00:00:00:21
20:23:00:00:00:22
20:23:00:00:00:23
20:23:00:00:00:24
20:23:00:00:00:25
20:23:00:00:00:26
20:23:00:00:00:27
20:23:00:00:00:28
20:23:00:00:00:29
20:23:00:00:00:30
20:23:00:00:00:31
20:23:00:00:00:33
20:23:00:00:00:34
20:23:00:00:00:35
20:23:00:00:00:36
20:23:00:00:00:37
20:23:00:00:00:38
20:23:00:00:00:39
20:23:00:00:00:40
20:23:00:00:00:41
20:23:00:00:00:42
20:23:00:00:00:43
20:23:00:00:00:44
20:23:00:00:00:45
20:23:00:00:00:46
20:23:00:00:00:47
20:23:00:00:00:48
20:23:00:00:00:49
20:23:00:00:00:50
20:23:00:00:00:51
20:23:00:00:00:52
20:23:00:00:00:53
20:23:00:00:00:54
20:23:00:00:00:55
20:23:00:00:00:56
20:23:00:00:00:57
20:23:00:00:00:58
20:23:00:00:00:59
20:23:00:00:00:60
20:23:00:00:00:61
20:23:00:00:00:62
20:23:00:00:00:63
20:23:00:00:00:64
20:23:00:00:00:65
20:23:00:00:00:67
20:23:00:00:00:68
20:23:00:00:00:69
20:23:00:00:00:71
20:23:00:00:00:72
20:23:00:00:00:73
20:23:00:00:00:76
20:23:00:00:00:78
20:23:00:00:00:79
20:23:00:00:00:80
20:23:00:00:00:81
20:23:00:00:00:82
20:23:00:00:00:84
20:23:00:00:00:85
20:23:00:00:00:87
20:23:00:00:00:88
20:23:00:00:00:89
20:23:00:00:00:90
20:23:00:00:00:91
20:23:00:00:00:92
20:23:00:00:00:93
20:23:00:00:00:94
20:23:00:00:00:95
20:23:00:00:00:96
20:23:00:00:00:97
20:23:00:00:00:98
20:23:00:00:00:99
20:23:00:00:01:00
20:23:00:00:01:01
20:23:00:00:01:02
20:23:00:00:01:03
20:23:00:00:01:04
20:23:00:00:01:05
20:23:00:00:01:06
20:23:00:00:01:07
20:23:00:00:01:08
20:23:00:00:01:09
20:23:00:00:01:10
20:23:00:00:01:11
20:23:00:00:01:12
20:23:00:00:01:13
20:23:00:00:01:14
20:23:00:00:01:15
20:23:00:00:01:16
20:23:00:00:01:17
20:23:00:00:01:18
20:23:00:00:01:19
20:23:00:00:01:20
20:23:00:00:01:21
20:23:00:00:01:22
20:23:00:00:01:23
20:23:00:00:01:24
20:23:00:00:01:25
20:23:00:00:01:26
20:23:00:00:01:27
20:23:00:00:01:28
20:23:00:00:01:29
20:23:00:00:01:31
20:23:00:00:01:32
20:23:00:00:01:33
20:23:00:00:01:34
20:23:00:00:01:35
20:23:00:00:01:36
20:23:00:00:01:37
20:23:00:00:01:38
20:23:00:00:01:39
20:23:00:00:01:40
20:23:00:00:01:41
20:23:00:00:01:42
20:23:00:00:01:43
20:23:00:00:01:44
20:23:00:00:01:45
20:23:00:00:01:46
20:23:00:00:01:47
20:23:00:00:01:50
20:23:00:00:01:51
20:23:00:00:01:52
20:23:00:00:01:53
20:23:00:00:01:54
20:23:00:00:01:55
20:23:00:00:01:56
20:23:00:00:01:58
20:23:00:00:01:59
20:23:00:00:01:60
20:23:00:00:01:61
20:23:00:00:01:62
20:23:00:00:01:63
20:23:00:00:01:64
20:23:00:00:01:65
20:23:00:00:01:66
20:23:00:00:01:67
20:23:00:00:01:68
20:23:00:00:01:69
20:23:00:00:01:70
20:23:00:00:01:71
20:23:00:00:01:72
20:23:00:00:01:73
20:23:00:00:01:74
20:23:00:00:01:75
20:23:00:00:01:76
20:23:00:00:01:77
20:23:00:00:01:78
20:23:00:00:01:81
20:23:00:00:01:82
20:23:00:00:01:83
20:23:00:00:01:84
20:23:00:00:01:85
20:23:00:00:01:86
20:23:00:00:01:87
20:23:00:00:01:88
20:23:00:00:01:89
20:23:00:00:01:90
20:23:00:00:01:91
20:23:00:00:01:92
20:23:00:00:01:93
20:23:00:00:01:94
20:23:00:00:01:95
20:23:00:00:01:96
20:23:00:00:01:97
20:23:00:00:01:98
20:23:00:00:01:99
20:23:00:00:02:01
20:23:00:00:02:02
20:23:00:00:02:03
20:23:00:00:02:04
20:23:00:00:02:05
20:23:00:00:02:06
20:23:00:00:02:07
20:23:00:00:02:09
20:23:00:00:02:10
20:23:00:00:02:11
20:23:00:00:02:12
20:23:00:00:02:13
20:23:00:00:02:14
20:23:00:00:02:15
20:23:00:00:02:16
20:23:00:00:02:17
20:23:00:00:02:18
20:23:00:00:02:19
20:23:00:00:02:20
20:23:00:00:02:21
20:23:00:00:02:22
20:23:00:00:02:23
20:23:00:00:02:24
20:23:00:00:02:25
20:23:00:00:02:26
20:23:00:00:02:27
20:23:00:00:02:28
20:23:00:00:02:29
20:23:00:00:02:30
20:23:00:00:02:31
20:23:00:00:02:32
20:23:00:00:02:34
20:23:00:00:02:35
20:23:00:00:02:37
20:23:00:00:02:39
20:23:00:00:02:41
20:23:00:00:02:46
20:23:00:00:02:54
20:23:00:00:02:55
20:23:00:00:02:56
20:23:00:00:02:57
20:23:00:00:02:58
20:23:00:00:02:59
20:23:00:00:02:60
20:23:00:00:02:61
20:23:00:00:02:62
20:23:00:00:02:65
20:23:00:00:02:67
20:23:00:00:02:70
20:23:00:00:02:73
20:23:00:00:02:74
20:23:00:00:02:76
20:23:00:00:02:77
20:23:00:00:02:78
20:23:00:00:02:79
20:23:00:00:02:80
20:23:00:00:02:81
20:23:00:00:02:82
20:23:00:00:02:83
20:23:00:00:02:84
20:23:00:00:02:85
20:23:00:00:02:86
20:23:00:00:02:87
20:23:00:00:02:88
20:23:00:00:02:89
20:23:00:00:02:90
20:23:00:00:02:91
20:23:00:00:02:92
20:23:00:00:02:93
20:23:00:00:02:94
20:23:00:00:02:95
20:23:00:00:02:96
20:23:00:00:02:97
20:23:00:00:02:98
20:23:00:00:02:99
20:23:00:00:03:00
20:23:00:00:03:01
20:23:00:00:03:02
20:23:00:00:03:03
20:23:00:00:03:04
20:23:00:00:03:05
20:23:00:00:03:06
20:23:00:00:03:07
20:23:00:00:03:08
20:23:00:00:03:09
20:23:00:00:03:10
20:23:00:00:03:11
20:23:00:00:03:12
20:23:00:00:03:13
20:23:00:00:03:14
20:23:00:00:03:15
20:23:00:00:03:16
20:23:00:00:03:17
20:23:00:00:03:18
20:23:00:00:03:19
20:23:00:00:03:20
20:23:00:00:03:21
20:23:00:00:03:22
20:23:00:00:03:23
20:23:00:00:03:24
20:23:00:00:03:25
20:23:00:00:03:26
20:23:00:00:03:27
20:23:00:00:03:28
20:23:00:00:03:29
20:23:00:00:03:30
20:23:00:00:03:31
20:23:00:00:03:32
20:23:00:00:03:33
20:23:00:00:03:34
20:23:00:00:03:35
20:23:00:00:03:36
20:23:00:00:03:37
20:23:00:00:03:38
20:23:00:00:03:39
20:23:00:00:03:40
20:23:00:00:03:41
20:23:00:00:03:42
20:23:00:00:03:43
20:23:00:00:03:44
20:23:00:00:03:45
20:23:00:00:03:46
20:23:00:00:03:47
20:23:00:00:03:48
